11111111111
10C0P0C00E1
11111111111