1111111
10C0C01
1P0C0E1
1111111