11111111111
1000PC001E1
11111111111