1111111111111111
100P0000000C00E1
10C00000C0000001
1C000000C0000001
1111111111111111
